

C    100,1  ,250

F                 244,123,26
NO
WE ./test44.xpm

SO ./test22.xpm


EA        ./test33.xpm

 111111111111111111111
1111100001111111111111111111111
1000000000000000000000000000011
11100000000001000000000000001
111111111111111111111111111111
111111111111111111111111111111
111000010000010000000000000001
111000000000010000000N00000001
111000000000010000000000000001
100000001000000000001000000001
111111111111111111111011111111
                     101100111
                     111111111
