NO ./textures/test11.xpm
SO ./textures/test44.xpm
WE ./textures/test33.xpm
EA ./textures/test22.xpm

F 220,100,0
C 225,30,0

11111111111111111111111
10000000000000000000001
10000000000000000000001
10000000000000000000001
10000000000000000000001
1000000N000000000000001
10000000000000000000001
10000000000000000000001
10000000000000000010001
11111111111111111111111
