NO ./textures/test11.xpm
SO ./textures/test44.xpm
WE ./textures/test33.xpm
EA ./textures/test22.xpm

F 220,100,0
C 225,30,0

1111111111111111111N111
10000000000000000000001
10000000000000000000001
10000000000000000000001
10000000000000000000001
10000001000000000000001
10000000000000000000001
10000000000000000000001
10000000000000000000001
11111111111111111111111
