SO ./textures/test44.xpm
NO ./textures/test11.xpm
WE ./textures/test33.xpm
EA ./textures/test22.xpm

F 100,200,253

C 200,105,1

1111111 1111111111111111111111111
1000001 100000000001000000000011
1111111 10110000000000000000000111111111111
        10000000000000000001E011
11111111101100000111000000000001111111111111
111111111111111111111111111111111111
1111111 111111 1111111
1
111111111111111111111111111111111111
1111111110110000111000000000001111
1000000000110000111011111011111
11110111111111111100000010001
11110111111111 111010100100011
11000000110101111100000010001
10001000000000001100000010001
10000000000000001101010000001
1100000111010101111101111000111
11110111 1110101 101111010001
11111111 1111111 111111111111
1
